AD钙奶瓶	recyclable
A四纸	recyclable
CD	recyclable
CD塑料盒	recyclable
CD机	recyclable
CPU	recyclable
IPAD	recyclable
IPHONE X	recyclable
IPHONE手机	recyclable
KINDLE	recyclable
KINDLE壳	dry_garbage
KT板	recyclable
LED手电筒	recyclable
LED灯	harmful_waste
LED灯泡	harmful_waste
MP三	recyclable
PET瓶	recyclable
PE塑料	recyclable
PIZZA盒	dry_garbage
PP管	recyclable
PVC	recyclable
PVC瓶	recyclable
U型回形针	dry_garbage
U盘	recyclable
XBOX	recyclable
X光片	harmful_waste
X光胶片	harmful_waste
ZIPPO打火机	dry_garbage
一号无汞电池	dry_garbage
一块墙皮	dry_garbage
一次塑料杯	dry_garbage
一次性叉子	dry_garbage
一次性杯子	dry_garbage
一次性碗	dry_garbage
一次性莱盒	dry_garbage
一次性透明盒子	dry_garbage
一次性餐具	dry_garbage
一般铁罐	recyclable
丁字裤	dry_garbage
七号无汞电池	dry_garbage
万能胶水	dry_garbage
三文鱼	wet_garbage
三明治	wet_garbage
三明治包装	dry_garbage
三杯鸡	wet_garbage
三点五英寸软盘	dry_garbage
上衣	recyclable
不干胶纸	dry_garbage
不粘锅	recyclable
不锈钢	recyclable
不锈钢刀	recyclable
不锈钢勺子	recyclable
不锈钢垃圾桶	recyclable
不锈钢杯子	recyclable
丙烯	dry_garbage
丙烯颜料	dry_garbage
丝瓜瓤	wet_garbage
丝绸制品	recyclable
丝袜	dry_garbage
个人计算机	recyclable
中成药	harmful_waste
中草药	wet_garbage
中药	wet_garbage
中药材	wet_garbage
中药药渣	wet_garbage
串串竹签	dry_garbage
串串纸杯	dry_garbage
主机板	recyclable
主板	recyclable
乌龟壳	dry_garbage
乐事薯片	wet_garbage
乐利包	recyclable
乐高	recyclable
乒乓板	dry_garbage
乒乓球	dry_garbage
书	recyclable
书法纸	recyclable
书籍	recyclable
买菜的包装袋	dry_garbage
乳液瓶	recyclable
乳液罐	recyclable
乳牙	dry_garbage
二手衣物	recyclable
五号无汞电池	dry_garbage
五零二胶水	dry_garbage
亚克力	recyclable
亚克力板	recyclable
亚克力胶水	dry_garbage
交通卡	recyclable
人造奶油	wet_garbage
人造玻璃	recyclable
人造纤维	dry_garbage
仙人掌	wet_garbage
仙人球	wet_garbage
优盘	recyclable
会员卡	recyclable
伞	dry_garbage
传单	recyclable
传真机	recyclable
传真纸	recyclable
低温牛奶盒子	recyclable
体温计	harmful_waste
体重秤	recyclable
作业本	recyclable
作文书	recyclable
使用的餐巾纸	dry_garbage
使用过的猫砂	dry_garbage
使用过的餐盒	dry_garbage
便利贴	dry_garbage
便条贴	dry_garbage
便签	dry_garbage
便签纸	dry_garbage
便纸	dry_garbage
保健品	harmful_waste
保冷剂	dry_garbage
保暖杯	recyclable
保暖瓶	recyclable
保温壶	recyclable
保温杯	recyclable
保温棉	dry_garbage
保温瓶	recyclable
保温袋	recyclable
保湿喷雾	dry_garbage
保险套	dry_garbage
保险箱	recyclable
保鲜冰袋	dry_garbage
保鲜膜	dry_garbage
保鲜膜带齿盒	recyclable
保鲜袋	dry_garbage
保龄球	dry_garbage
信封	recyclable
信封带	recyclable
信用卡	recyclable
修正带	dry_garbage
修正带内芯	dry_garbage
假发	dry_garbage
假发套	dry_garbage
假牙	dry_garbage
假睫毛	dry_garbage
假睫毛胶水	dry_garbage
健身器材	recyclable
储奶袋	dry_garbage
儿童尿不湿	dry_garbage
儿童玩具	recyclable
儿童电动玩具	recyclable
充气娃	recyclable
充电器	recyclable
充电宝	recyclable
充电热水袋	recyclable
充电牙刷	recyclable
充电电池	harmful_waste
充电线	recyclable
充电装置	recyclable
光盘	dry_garbage
光碟	dry_garbage
光碟包	dry_garbage
光驱	recyclable
兔头	wet_garbage
兔肉	wet_garbage
入厕用纸	dry_garbage
八宝粥	wet_garbage
八宝粥罐	recyclable
八宝饭	wet_garbage
八角	wet_garbage
公交卡	recyclable
公仔	recyclable
公文包	recyclable
关东煮纸杯	dry_garbage
其他垃圾桶	recyclable
养乐多瓶	recyclable
养生壶	recyclable
养身壶	recyclable
内存卡	recyclable
内存条	recyclable
内脏	wet_garbage
内衣	dry_garbage
内表面附塑料膜的咖啡纸杯	dry_garbage
内裤	dry_garbage
再生纸	recyclable
写字纸	recyclable
写过的草稿纸	recyclable
农药片	harmful_waste
冥币	dry_garbage
冬枣核	wet_garbage
冬瓜	wet_garbage
冬笋壳	wet_garbage
冰宝宝贴	dry_garbage
冰柜	recyclable
冰棍棒	dry_garbage
冰棒皮	dry_garbage
冰淇淋	wet_garbage
冰淇淋包装袋	dry_garbage
冰淇淋盒	recyclable
冰淇淋纸	dry_garbage
冰激凌	wet_garbage
冰激凌木棒	dry_garbage
冰激淋	wet_garbage
冰箱	recyclable
冰箱贴	dry_garbage
冰糖	wet_garbage
冰袋	dry_garbage
冰贴	dry_garbage
冲泡饮料	wet_garbage
冷冻食品	wet_garbage
冷饮	dry_garbage
冷饮包装	dry_garbage
冷饮包装纸	dry_garbage
冷饮棒	dry_garbage
冷饮袋	dry_garbage
冻干粉面膜	dry_garbage
净化器滤芯	dry_garbage
净水器	recyclable
净水滤芯	dry_garbage
凉席	dry_garbage
凉皮	wet_garbage
凉鞋	recyclable
凳子	recyclable
刀	recyclable
刀片	recyclable
刘海夹	dry_garbage
创口贴	dry_garbage
创可贴	dry_garbage
利乐包	recyclable
利乐包装	recyclable
别针	dry_garbage
刮胡子刀片	recyclable
剃须刀	dry_garbage
剃须刀片	recyclable
剃须泡瓶	recyclable
剩莱	wet_garbage
剩菜	wet_garbage
剩菜剩饭	wet_garbage
剩餐	wet_garbage
剩饭	wet_garbage
剪刀	recyclable
剪子	recyclable
剪纸	dry_garbage
办公桌	recyclable
办公用纸	recyclable
加工类食品	wet_garbage
加湿器	recyclable
动物内脏	wet_garbage
动物毛	dry_garbage
勺子	recyclable
勾线笔	dry_garbage
包	recyclable
包书纸	recyclable
包包	recyclable
包子	wet_garbage
包装干燥剂	dry_garbage
包装用纸	recyclable
包装盒	recyclable
包装纸	recyclable
包装薄膜	dry_garbage
包裹着口香糖的纸巾	dry_garbage
包裹着宠物便便的塑料袋	dry_garbage
包裹着宠物便便的报纸	dry_garbage
包裹着宠物便便的纸巾	dry_garbage
包裹着宠物便便的膨润土猫砂	dry_garbage
包裹着痰的纸巾	dry_garbage
包裹着西瓜籽的纸巾	dry_garbage
包裹着鸡蛋壳的纸巾	dry_garbage
包裹着鼻涕的纸巾	dry_garbage
化妆刷	dry_garbage
化妆品外包装纸盒	recyclable
化妆品密封塑料膜	dry_garbage
化妆品玻璃瓶	recyclable
化妆品瓶	recyclable
化妆品瓶盖	dry_garbage
化妆棉	dry_garbage
化妆水瓶	recyclable
化妆镜	dry_garbage
化学试剂包装玻璃瓶	harmful_waste
化纤衣物	recyclable
医用冰袋	dry_garbage
医用棉签	harmful_waste
午餐肉	wet_garbage
午餐肉罐	recyclable
午饭	wet_garbage
华为P二十	recyclable
华为手机	recyclable
南瓜	wet_garbage
南瓜子壳	wet_garbage
南瓜皮	wet_garbage
卡	dry_garbage
卡纸	recyclable
卤料包	dry_garbage
卤素灯	harmful_waste
卤素灯泡	harmful_waste
卫生巾	dry_garbage
卫生间废纸	dry_garbage
卫生间用纸	dry_garbage
卫生间纸	dry_garbage
卫衣	recyclable
印台	dry_garbage
印泥	dry_garbage
即冲奶茶包装盒	recyclable
卷烟	dry_garbage
卷笔刀	dry_garbage
卷筒纸	dry_garbage
卷筒纸内芯	dry_garbage
卷筒纸内芯	recyclable
卷筒纸外包装	dry_garbage
卷纸芯	recyclable
卸妆巾	dry_garbage
卸妆棉	dry_garbage
卸妆油	dry_garbage
压力罐	recyclable
压力锅	recyclable
压缩瓶	recyclable
厕所手纸	dry_garbage
厕所用纸	dry_garbage
厕所纸	dry_garbage
厕纸	dry_garbage
厚型塑料袋	dry_garbage
厚塑料袋	dry_garbage
厚纸板	recyclable
原味鸡	wet_garbage
原子笔	dry_garbage
原珠笔	dry_garbage
厨余	wet_garbage
厨余垃圾	wet_garbage
厨余果皮	wet_garbage
厨房垃圾	wet_garbage
厨房手套	dry_garbage
厨房用纸	dry_garbage
厨房纸	dry_garbage
厨房纸巾	dry_garbage
叉子	recyclable
双面胶	dry_garbage
双面胶带	dry_garbage
发卡	dry_garbage
发圈	dry_garbage
发夹	dry_garbage
发带	dry_garbage
发泡网	dry_garbage
发热包	dry_garbage
发票	dry_garbage
发胶	dry_garbage
发蜡	dry_garbage
发霉食物	wet_garbage
取号纸	dry_garbage
受污纸巾	dry_garbage
受潮的纸张	recyclable
受过污染的纸	dry_garbage
变形金刚	recyclable
变质的食物	wet_garbage
变质食品	wet_garbage
口红	dry_garbage
口红盒	dry_garbage
口罩	dry_garbage
口香糖	dry_garbage
口香糖塑料盒	recyclable
古筝	recyclable
可丽饼	wet_garbage
可乐杯	dry_garbage
可乐玻璃瓶	recyclable
可乐罐	recyclable
可回收	recyclable
可擦笔	dry_garbage
可降解垃圾袋	dry_garbage
可降解塑料	recyclable
可降解塑料袋	dry_garbage
台历	recyclable
台灯	recyclable
叶	wet_garbage
吃剩下的牡蛎壳	dry_garbage
吃剩下的葡萄杆	wet_garbage
吃剩的快餐	wet_garbage
吃过的奇趣蛋	dry_garbage
吃过的棒棒糖	dry_garbage
吃过的甘蔗	wet_garbage
各式皮包	recyclable
各类刀	recyclable
各类过期食品	wet_garbage
合金玩具	recyclable
合金筷子	recyclable
吊牌	recyclable
名片	recyclable
名画	dry_garbage
含汞体温计	harmful_waste
含汞温度计	harmful_waste
含汞血压计	harmful_waste
含油抹布	dry_garbage
吸尘器	recyclable
吸潮剂	dry_garbage
吸管	dry_garbage
吸顶灯	harmful_waste
吹风机	recyclable
呕吐包	dry_garbage
呕吐物	wet_garbage
味精	wet_garbage
呼叫器	recyclable
呼啦圈	recyclable
咖啡	wet_garbage
咖啡包	wet_garbage
咖啡杯套	recyclable
咖啡杯盖	dry_garbage
咖啡渣	wet_garbage
咖啡纸杯	dry_garbage
咖啡胶囊	dry_garbage
咖啡袋	dry_garbage
咖啡隔热纸	recyclable
咬过的口香糖	dry_garbage
咳嗽糖浆	harmful_waste
咸菜	wet_garbage
咸鱼	wet_garbage
咸鸭蛋壳	wet_garbage
哈密瓜皮	wet_garbage
哑铃	recyclable
唇膏	dry_garbage
唇釉	dry_garbage
唱片	dry_garbage
啤酒瓶	recyclable
啤酒盖	recyclable
啤酒罐	recyclable
喝完了的酸奶瓶	recyclable
喝完的药瓶	harmful_waste
喝过的茶叶	wet_garbage
喝过的茶叶渣	wet_garbage
喷蟑螂瓶	harmful_waste
回形针	dry_garbage
回收物	recyclable
围巾	recyclable
围裙	recyclable
固体清香剂	dry_garbage
固体胶	dry_garbage
图画	dry_garbage
图章	dry_garbage
图钉	dry_garbage
圆珠笔	dry_garbage
土豆	wet_garbage
圣女果	wet_garbage
地图	recyclable
地板砖	recyclable
地板蜡	dry_garbage
地毯	recyclable
地球仪	recyclable
地铁票	recyclable
坏了的玩具	recyclable
坏了的碗	recyclable
坏发卡	dry_garbage
坏钢笔	dry_garbage
坚果	dry_garbage
坚果壳	dry_garbage
坚果果壳	dry_garbage
垃圾桶	recyclable
垃圾箱	recyclable
垃圾袋	dry_garbage
垫子	recyclable
塑料	recyclable
塑料勺	dry_garbage
塑料卡片	recyclable
塑料叉子	dry_garbage
塑料托盘	recyclable
塑料收纳盒	recyclable
塑料晾衣架	recyclable
塑料模型	recyclable
塑料水果筐	recyclable
塑料玩具	recyclable
塑料盒子	recyclable
塑料碗	recyclable
塑料积木	recyclable
塑料筐	recyclable
塑料管道	recyclable
塑料篮筐	recyclable
塑料纽扣	recyclable
塑料脸盆	recyclable
塑料薄膜	dry_garbage
塑料衣架	recyclable
塑料袋	dry_garbage
塑料购物袋	dry_garbage
塑胶制资料夹	recyclable
塑胶菜蓝子	recyclable
墙刷	dry_garbage
墨囊	dry_garbage
墨水笔	dry_garbage
墨水笔墨胆	dry_garbage
墨汁瓶	recyclable
墨盒	recyclable
墨粉	dry_garbage
墨胆	dry_garbage
墨襄	dry_garbage
墨镜	dry_garbage
壁纸	dry_garbage
复写纸	dry_garbage
复印件版纸	recyclable
复印机	recyclable
复印纸	recyclable
复合包装	dry_garbage
夏威夷果	dry_garbage
夏威夷果壳	dry_garbage
夏威夷果的壳	dry_garbage
外卖盒	dry_garbage
外卖餐盒	dry_garbage
外套	recyclable
多肉	wet_garbage
多肉植物	wet_garbage
大哥大	recyclable
大头针	dry_garbage
大头钉	dry_garbage
大排	wet_garbage
大提琴	recyclable
大米	wet_garbage
大米袋	dry_garbage
大葱	wet_garbage
大蒜	wet_garbage
大衣	recyclable
大豆	wet_garbage
大闸蟹	wet_garbage
大闸蟹壳	wet_garbage
大饼	wet_garbage
大骨	dry_garbage
大骨头	dry_garbage
大龙虾	wet_garbage
大龙虾壳	dry_garbage
大龙虾头	dry_garbage
太空沙	dry_garbage
太阳帽	recyclable
太阳能热水器	recyclable
太阳能热水管	recyclable
夫妻肺片	wet_garbage
头盔	dry_garbage
夹克	recyclable
奥特曼卡牌	recyclable
奥特曼玩具	recyclable
女性卫生用品	dry_garbage
女生内衣	dry_garbage
奶瓶	recyclable
奶盒	recyclable
奶粉	wet_garbage
奶罩	dry_garbage
奶酪	wet_garbage
姜	wet_garbage
姨妈巾	dry_garbage
婚戒	recyclable
婴儿尿不湿	dry_garbage
婴儿尿布	dry_garbage
婴儿纸尿裤	dry_garbage
婴幼儿尿布	dry_garbage
子弹	dry_garbage
孩子尿片	dry_garbage
安全套	dry_garbage
安全套包装袋	dry_garbage
安全帽	recyclable
宝特瓶	recyclable
宠物尿垫	dry_garbage
宠物毛	dry_garbage
宠物毛发	dry_garbage
宠物罐头	dry_garbage
宠物饲料	wet_garbage
宠物饲料包装袋	dry_garbage
宣传册	recyclable
宣传单	recyclable
宣传页	recyclable
宣纸	dry_garbage
家养绿植	wet_garbage
家庭盆栽树叶	wet_garbage
家庭绿化	wet_garbage
家庭花卉	wet_garbage
家电	recyclable
家电家具	recyclable
家禽内脏	wet_garbage
密封袋	dry_garbage
密码锁	recyclable
密胺碗	recyclable
密胺餐具	recyclable
富贵竹	wet_garbage
导线	recyclable
寿司	wet_garbage
封箱带	dry_garbage
小修正带	dry_garbage
小刀	recyclable
小孩尿布	dry_garbage
小广告	recyclable
小骨	wet_garbage
少年报	recyclable
少量泥土	dry_garbage
尘土	dry_garbage
尺	dry_garbage
尺子	recyclable
尼龙丝袜	dry_garbage
尼龙制品	dry_garbage
尼龙绳	dry_garbage
尿不湿	dry_garbage
尿垫	dry_garbage
尿布	dry_garbage
尿裤	dry_garbage
屏幕	recyclable
屠龙刀	recyclable
山竹	wet_garbage
山芋	wet_garbage
工资卡	recyclable
巧克力	wet_garbage
巧克力盒子	dry_garbage
巧克力袋子	dry_garbage
巴旦木壳	wet_garbage
布	recyclable
布偶	recyclable
布包	recyclable
布娃娃	recyclable
布料	recyclable
布条	recyclable
布玩偶	recyclable
布类	recyclable
布艺窗帘	recyclable
布袋	recyclable
布质化妆包	recyclable
布鞋	recyclable
布鞋套	recyclable
帆布包	recyclable
帆布袋	recyclable
帆布鞋	recyclable
帐篷	recyclable
带有婴儿便便的尿不湿	dry_garbage
带有婴儿便便的纸尿裤	dry_garbage
带油抹布	dry_garbage
带胶制品	dry_garbage
常温牛奶盒	recyclable
常温牛奶盒子	recyclable
帽子	recyclable
幕布	recyclable
干冰	dry_garbage
干冰袋	dry_garbage
干净塑料	recyclable
干净无油食品包装袋	dry_garbage
干净饮料瓶	recyclable
干发巾	dry_garbage
干发帽	recyclable
干垃圾	dry_garbage
干拉圾	dry_garbage
干拌面	wet_garbage
干果	wet_garbage
干枯玫瑰花	wet_garbage
干枯花	wet_garbage
干燥剂	dry_garbage
干花	wet_garbage
干草	dry_garbage
干草包装袋	dry_garbage
干货	wet_garbage
平常喝的茶叶	wet_garbage
平底锅	recyclable
平板玻璃	recyclable
平板电脑	recyclable
年糕	wet_garbage
广告单	recyclable
广告单页	recyclable
广告用纸	recyclable
广告纸	recyclable
广告纸片	recyclable
广告颜料	dry_garbage
床上用品	recyclable
床单	recyclable
床垫	recyclable
床罩	recyclable
底片	dry_garbage
废书	recyclable
废乳瓶	recyclable
废台式机	recyclable
废含汞温度计	harmful_waste
废含汞血压计	harmful_waste
废塑料	recyclable
废家电	recyclable
废弃书本	recyclable
废弃地毯	recyclable
废弃塑料文具	recyclable
废弃布包	recyclable
废弃电线	recyclable
废弃纸张	dry_garbage
废弃衣服	recyclable
废弃计算机	recyclable
废弃食品袋	dry_garbage
废报纸	recyclable
废抹布	dry_garbage
废旧吸铁石	recyclable
废旧小家电	recyclable
废旧报纸	recyclable
废旧木材	recyclable
废旧电子产品	recyclable
废植物	wet_garbage
废橡胶	dry_garbage
废氧化汞电池	harmful_waste
废油漆	harmful_waste
废油漆桶	harmful_waste
废温度计	harmful_waste
废灭火器	recyclable
废玻璃制品	recyclable
废电视	recyclable
废电路板	recyclable
废直式日光灯管	harmful_waste
废相纸	harmful_waste
废纸	recyclable
废纸张	recyclable
废织物	recyclable
废胶片	harmful_waste
废节能灯	harmful_waste
废荧光灯管	harmful_waste
废药	harmful_waste
废药品及其包装物	harmful_waste
废衣服	recyclable
废踏垫	dry_garbage
废金属	recyclable
废钥匙	recyclable
废铁	recyclable
废铜烂铁	recyclable
废铝	recyclable
废锁头	recyclable
废键盘	recyclable
废镍镉电池	harmful_waste
废食用油瓶	recyclable
开关	recyclable
开心果	dry_garbage
开心果壳	dry_garbage
弹簧	recyclable
强化玻璃	recyclable
录像带	harmful_waste
录放机	recyclable
录音机	recyclable
彩妆	dry_garbage
彩电	recyclable
彩票	dry_garbage
彩笔	dry_garbage
彩色玻璃	recyclable
彩色笔	dry_garbage
影印纸	recyclable
微波炉	recyclable
徽章	dry_garbage
快递包装袋	dry_garbage
快递单	dry_garbage
快递盒	recyclable
快递箱	recyclable
快递纸箱	recyclable
快递纸袋	recyclable
快递袋	dry_garbage
快递贴纸	dry_garbage
快速面盒	dry_garbage
快餐盒	dry_garbage
急支糖浆	harmful_waste
情趣内衣	dry_garbage
感光片	harmful_waste
感光胶片	harmful_waste
感冒药	harmful_waste
成人尿布	dry_garbage
成人用品	dry_garbage
成分复杂的制品	dry_garbage
戒指	recyclable
扇贝	wet_garbage
手串	dry_garbage
手册	recyclable
手办	recyclable
手帕	dry_garbage
手抄报	dry_garbage
手指甲脚趾甲	dry_garbage
手提电脑	recyclable
手撕猪肉	wet_garbage
手环	dry_garbage
手表	recyclable
扎带	dry_garbage
扑克	recyclable
扑克牌	recyclable
打包盒	dry_garbage
打包袋	dry_garbage
打印出来的纸	recyclable
打印后的彩色照片	harmful_waste
打印机	recyclable
打印机墨盒	recyclable
打印机色带	recyclable
打印纸	recyclable
打印间碎纸	recyclable
打底裤	recyclable
打气筒	recyclable
打火机	dry_garbage
扣子	dry_garbage
扫地机	recyclable
扫帚	dry_garbage
扫把	dry_garbage
折扇	dry_garbage
护发精油	dry_garbage
护发素瓶	recyclable
护垫	dry_garbage
护手霜	dry_garbage
护理垫	dry_garbage
护目镜	dry_garbage
护肤乳液瓶	recyclable
护肤品	dry_garbage
护肤品玻璃罐	recyclable
护肤品瓶	recyclable
护肤霜瓶	recyclable
护脸霜瓶	recyclable
报刊	recyclable
报废车辆	recyclable
报纸	recyclable
披萨	wet_garbage
披萨盒	dry_garbage
披萨饼盒	dry_garbage
抱枕	recyclable
抹布	dry_garbage
抽完的烟蒂	dry_garbage
抽纸	dry_garbage
抽纸塑料袋	dry_garbage
担担面	wet_garbage
拉拉裤	dry_garbage
拉杆箱	recyclable
拉链	dry_garbage
拍立得	recyclable
拖把	dry_garbage
拖鞋	recyclable
挂历	recyclable
挂号纸	recyclable
挂耳咖啡	dry_garbage
挂钟	recyclable
指甲	dry_garbage
指甲剪	recyclable
指甲油	harmful_waste
指甲钳	recyclable
按摩棒	dry_garbage
捆绑带	dry_garbage
捕蚊灯	recyclable
掉下来的牙齿	dry_garbage
掉落的头发	dry_garbage
接线板	recyclable
插头	recyclable
插座	recyclable
插排	recyclable
插线板	recyclable
搅拌勺	dry_garbage
搅拌器	recyclable
搅拌棒	dry_garbage
搓澡巾	dry_garbage
搓衣板	recyclable
搪瓷	recyclable
搪瓷杯	dry_garbage
搪瓷碗	recyclable
搽鼻涕纸	dry_garbage
摄像头	recyclable
摄像机	recyclable
摩丝	dry_garbage
摩丝罐	dry_garbage
摩易擦	dry_garbage
擀面杖	recyclable
擦完嘴的纸	dry_garbage
擦屎纸	dry_garbage
擦手巾	dry_garbage
擦拭过的餐巾纸	dry_garbage
擦眼泪的纸	dry_garbage
擦碗布	dry_garbage
擦纸巾	dry_garbage
擦过的鼻涕纸巾	dry_garbage
擦鼻涕纸	dry_garbage
收据	recyclable
收纳盒	recyclable
收纳箱	recyclable
收银条	recyclable
放大镜	recyclable
散粉	dry_garbage
数字音乐播放器	recyclable
数学书	recyclable
数据线	recyclable
敲碎的碗	dry_garbage
敷料	dry_garbage
文件夹	recyclable
文件袋	recyclable
文竹	wet_garbage
文胸	dry_garbage
料酒瓶	recyclable
方便筷	dry_garbage
方便面	wet_garbage
方便面包装袋	dry_garbage
方便面叉子	dry_garbage
方便面桶	dry_garbage
方便面调味包	dry_garbage
方便面调羹	dry_garbage
施工安全帽	recyclable
旅游时报	recyclable
旅行箱	recyclable
旅行袋	recyclable
无人机	recyclable
无汞干电池	dry_garbage
无汞电池	dry_garbage
无纺布	dry_garbage
无纺布袋	dry_garbage
无线路由器	recyclable
无菌包装塑料	dry_garbage
无菌注射器包装	dry_garbage
日光灯	harmful_waste
日光灯管	harmful_waste
日历	recyclable
日抛美瞳	dry_garbage
日报	recyclable
旧书	recyclable
旧书包	recyclable
旧剪刀	recyclable
旧包皮革	recyclable
旧口罩	dry_garbage
旧塑料篮子	recyclable
旧布鞋	recyclable
旧帽子	recyclable
旧手提包	recyclable
旧报	recyclable
旧报刊	recyclable
旧报纸	recyclable
旧抹布	dry_garbage
旧拖把	dry_garbage
旧拖鞋	recyclable
旧枕头	recyclable
旧棉絮	recyclable
旧毛巾	dry_garbage
旧照片	harmful_waste
旧牙刷	dry_garbage
旧玩偶	recyclable
旧玩具	recyclable
旧瑜伽垫	recyclable
旧皮鞋	recyclable
旧窗帘	recyclable
旧纸袋	recyclable
旧背包	recyclable
旧衣服	recyclable
旧衣服属于	recyclable
旧被单	recyclable
旧跑鞋	recyclable
旧运动鞋	recyclable
旧锁	recyclable
旧镜子	dry_garbage
旧雨伞	dry_garbage
旧鞋	recyclable
旧鞋子	recyclable
旧音箱	recyclable
早点盒	dry_garbage
明信片	recyclable
易拉宝	recyclable
易拉罐	recyclable
星巴克纸杯	dry_garbage
春梅	wet_garbage
显卡	recyclable
显示器	recyclable
显示屏幕	recyclable
晒鼓墨盒	recyclable
普通塑料袋	dry_garbage
晾衣杆	recyclable
晾衣架	recyclable
暖宝宝帖	dry_garbage
暖瓶	recyclable
曲别针	dry_garbage
曲奇	wet_garbage
月季	wet_garbage
月饼	wet_garbage
月饼盒	recyclable
有害垃圾	harmful_waste
有机溶剂	harmful_waste
有机玻璃	recyclable
有污渍的餐盒	dry_garbage
服装	recyclable
望远镜	recyclable
木凳	recyclable
木制品	recyclable
木勺	recyclable
木塞	dry_garbage
木头	recyclable
木屑	dry_garbage
木条	recyclable
木板	recyclable
木桶	recyclable
木梳	recyclable
木梳子	recyclable
木棍	recyclable
木棒	recyclable
木炭	dry_garbage
木瓶塞	dry_garbage
木盒	recyclable
木砧板	recyclable
木积木	recyclable
木筷	recyclable
木质拖把杆	recyclable
木质拼版	recyclable
木质搅拌棒	dry_garbage
木质梳子	dry_garbage
木质猫爬架	recyclable
木质砧板	recyclable
木质花架	recyclable
木质菜板	recyclable
木质锅铲	recyclable
木铲板	recyclable
木雕	recyclable
未使用的餐巾纸	dry_garbage
本子	recyclable
机械表	recyclable
机箱	recyclable
机顶盒	recyclable
杀毒剂	harmful_waste
杀菌剂	harmful_waste
杀虫剂	harmful_waste
杀虫剂包装	harmful_waste
杀虫喷雾	harmful_waste
杀虫喷雾罐	harmful_waste
杂志	recyclable
杂草	wet_garbage
杏仁	wet_garbage
杏仁壳	wet_garbage
杜蕾斯	dry_garbage
杨梅	wet_garbage
杯垫	recyclable
杯子	dry_garbage
松子	dry_garbage
松子壳	dry_garbage
松木猫砂	dry_garbage
板擦儿	dry_garbage
板栗	wet_garbage
板栗壳	wet_garbage
枕头	recyclable
枕套	recyclable
果冻	wet_garbage
果冻包装盒	dry_garbage
果冻壳	dry_garbage
果冻杯	recyclable
果冻盒	dry_garbage
果实	wet_garbage
果核	wet_garbage
果粒	wet_garbage
果茶罐	recyclable
果酱	wet_garbage
果酱瓶	recyclable
枝叶	wet_garbage
枣	wet_garbage
枣核	wet_garbage
枯叶	wet_garbage
枯枝	wet_garbage
枯萎的花	wet_garbage
枯萎的鲜花	wet_garbage
染发剂壳	harmful_waste
染发剂罐	harmful_waste
柠檬	wet_garbage
标签	dry_garbage
标签卡	dry_garbage
标签纸	dry_garbage
标签色带	dry_garbage
树叶	wet_garbage
树枝	wet_garbage
树根	wet_garbage
树皮	wet_garbage
树脂	dry_garbage
栗子	wet_garbage
核桃壳	dry_garbage
根茎蔬菜	wet_garbage
桂圆	wet_garbage
桂圆壳	wet_garbage
桂圆核	wet_garbage
桃板	wet_garbage
桃核	wet_garbage
桑叶	wet_garbage
桔	wet_garbage
桔子皮	wet_garbage
桔柑	wet_garbage
桔梗	wet_garbage
档案袋	recyclable
梨	wet_garbage
梨核	wet_garbage
梭子蟹	wet_garbage
梳子	dry_garbage
棉	recyclable
棉布	recyclable
棉柔巾	dry_garbage
棉棒	dry_garbage
棉球	dry_garbage
棉签	dry_garbage
棉签盒	recyclable
棉线	dry_garbage
棉绳	dry_garbage
棉花棒	dry_garbage
棉花球	dry_garbage
棉花被	recyclable
棉袄	recyclable
棉袜	recyclable
棉被	recyclable
棒冰包装袋	dry_garbage
棒冰棍	dry_garbage
棒棒糖棒子	dry_garbage
棒骨	dry_garbage
棕叶	dry_garbage
棕子叶	dry_garbage
棕子皮	dry_garbage
植物	wet_garbage
椰壳	dry_garbage
椰子	dry_garbage
椰子壳	dry_garbage
椰子肉	wet_garbage
榔头	recyclable
榴莲壳	dry_garbage
榴莲干	wet_garbage
榴莲核	dry_garbage
槟榔	wet_garbage
槟榔壳	wet_garbage
樱桃	wet_garbage
樱桃核	wet_garbage
樱花	wet_garbage
橄榄球	recyclable
橙	wet_garbage
橙子	wet_garbage
橙皮	wet_garbage
橡皮	dry_garbage
橡皮泥	dry_garbage
橡胶	dry_garbage
死昆虫	wet_garbage
死老鼠	wet_garbage
死花	wet_garbage
残枝	wet_garbage
残羹	wet_garbage
残花	wet_garbage
毒鼠强	harmful_waste
毛发	dry_garbage
毛巾	dry_garbage
毛毯	recyclable
毛皮	recyclable
毛竹	dry_garbage
毛笔	dry_garbage
毛笔写过的纸	dry_garbage
毛线	recyclable
毛绒玩具	recyclable
毛衣针	dry_garbage
毛豆结	wet_garbage
毛领子	recyclable
气球	dry_garbage
氢气球	dry_garbage
氢气球充气钢瓶	recyclable
氢气罐	recyclable
氯化钙除湿剂	dry_garbage
水产	wet_garbage
水产及其加工食品	wet_garbage
水产类弃物	wet_garbage
水垢	dry_garbage
水培植物	wet_garbage
水彩	dry_garbage
水性漆	harmful_waste
水性笔	dry_garbage
水斗漏网	dry_garbage
水果果皮	wet_garbage
水果果肉	wet_garbage
水果网套	recyclable
水果脆	wet_garbage
水果茎枝	wet_garbage
水煮肉片	wet_garbage
水笔	dry_garbage
水笔外壳	dry_garbage
水银	harmful_waste
水银体温计	harmful_waste
水银温度计	harmful_waste
水银血压计	harmful_waste
水饺	wet_garbage
水饺袋	dry_garbage
汉堡	wet_garbage
汉堡包	wet_garbage
汉堡盒	dry_garbage
汗衫	recyclable
污损塑料	dry_garbage
污损纸张	dry_garbage
污染严重的纸	dry_garbage
污染严重的纸张	dry_garbage
污染严重的纸盒	dry_garbage
污染报纸	dry_garbage
污染较严重的纸张	dry_garbage
污水袋	dry_garbage
汤骨	dry_garbage
汽车空气滤清器	recyclable
汽车雨刮器	dry_garbage
沐浴乳	dry_garbage
沐浴球	dry_garbage
沐浴露瓶	recyclable
没用过尿片	dry_garbage
没用过的尿不湿	dry_garbage
没用过的纸杯	dry_garbage
沥干后的固体废弃物	wet_garbage
沥水架	recyclable
河蚌壳	dry_garbage
河豚	wet_garbage
沸石猫砂	dry_garbage
油壶	recyclable
油污布	dry_garbage
油渍的报纸	dry_garbage
油漆	harmful_waste
油漆包装	harmful_waste
油漆稀释剂	harmful_waste
油脂	wet_garbage
油腻的餐巾纸	dry_garbage
沾了油污的报纸	recyclable
沾了菜油的餐巾纸	recyclable
沾有墨水的纸	dry_garbage
泔脚	wet_garbage
泡沫	recyclable
泡沫塑料	recyclable
泡沫填充	dry_garbage
泡沫板	recyclable
泡沫箱属于什么垃圾	recyclable
泡面	wet_garbage
泡馍	wet_garbage
泥巴	dry_garbage
注射器	dry_garbage
洁厕灵瓶子	recyclable
洁面仪	recyclable
洋装	recyclable
洋钉	recyclable
洗净后的牛奶盒	recyclable
洗发水	dry_garbage
洗发水瓶	recyclable
洗发精	dry_garbage
洗发露瓶	recyclable
洗澡掉的头发	dry_garbage
洗甲水	harmful_waste
洗脸巾	dry_garbage
活性炭	dry_garbage
活性炭滤芯	dry_garbage
浆糊	dry_garbage
测血糖试纸	dry_garbage
测血糖针	dry_garbage
测试卷	recyclable
浴巾	dry_garbage
浴帽	dry_garbage
浴霸灯	recyclable
浴霸灯泡	harmful_waste
海带	wet_garbage
海报	recyclable
海洋球	recyclable
海绵	dry_garbage
海绵垫	dry_garbage
海绵粉扑	dry_garbage
海绵纸	dry_garbage
海绵蛋	dry_garbage
海胆	wet_garbage
海胆壳	dry_garbage
海苔	wet_garbage
海苔袋子	dry_garbage
海螺	wet_garbage
海螺壳	dry_garbage
海鲜	wet_garbage
涂改笔	dry_garbage
涂料	harmful_waste
涂料桶	harmful_waste
消毒药片	harmful_waste
润发乳	dry_garbage
润唇膏	dry_garbage
润滑剂	dry_garbage
润滑油	dry_garbage
润肤霜	recyclable
液晶屏	recyclable
液晶电视	recyclable
淀粉	wet_garbage
淘宝纸盒	recyclable
淡菜	wet_garbage
混合猫砂	dry_garbage
清洁瓶	recyclable
温度计	harmful_waste
游戏币	recyclable
游戏手柄	recyclable
游戏机	recyclable
游泳裤	recyclable
湿巾	dry_garbage
湿纸	dry_garbage
溜冰鞋	recyclable
溜溜球	dry_garbage
溶剂	harmful_waste
溶剂包装	harmful_waste
滑板	recyclable
滤尘袋	dry_garbage
滤挂咖啡	dry_garbage
滤清器	dry_garbage
滤纸	dry_garbage
滤网	dry_garbage
滤芯	dry_garbage
滴漏式咖啡	dry_garbage
滴露瓶	recyclable
漂白剂罐	harmful_waste
漂白粉	dry_garbage
漆桶	harmful_waste
漫画	recyclable
漫画书	recyclable
漱口水瓶子	recyclable
火机	dry_garbage
火柴	dry_garbage
火腿	wet_garbage
火腿肠包装纸	dry_garbage
火车票	dry_garbage
火锅	wet_garbage
火锅汤底	wet_garbage
火锅蘸酱	wet_garbage
灭火器	recyclable
灭蚊剂	harmful_waste
灭蚊灯	dry_garbage
灭蚊片	dry_garbage
灯泡	harmful_waste
灯炮	harmful_waste
灯管	harmful_waste
灰	dry_garbage
灰土	dry_garbage
灰尘	dry_garbage
炉渣	dry_garbage
炒板栗	wet_garbage
炒花生壳	wet_garbage
炒菜铁锅	recyclable
炒面	wet_garbage
炭包	dry_garbage
炸鸡	wet_garbage
点心盒	recyclable
点钞机	recyclable
炼乳壳	dry_garbage
烂桃	wet_garbage
烂桔	wet_garbage
烂苹果	wet_garbage
烂菜叶	wet_garbage
烂蔬菜	wet_garbage
烂香蕉	wet_garbage
烘干机	recyclable
烘手器	recyclable
烘焙纸	dry_garbage
烟屁股	dry_garbage
烟缸	recyclable
烟蒂	dry_garbage
烤箱	recyclable
烧串棒	dry_garbage
烧卖	wet_garbage
烧烤棒	dry_garbage
烧鸡	wet_garbage
烫伤膏	harmful_waste
焊丝	recyclable
煎鍋	recyclable
煤气罐	recyclable
煤渣	dry_garbage
煤灰	dry_garbage
煤饼	dry_garbage
照片	harmful_waste
照片纸	harmful_waste
煮花生壳	wet_garbage
熟菜	wet_garbage
熟虾壳	wet_garbage
熟鸡蛋	wet_garbage
燃油罐	recyclable
燕尾夹	recyclable
燕窝	wet_garbage
爆竹	dry_garbage
爆米花	wet_garbage
爽肤水瓶	recyclable
牙	dry_garbage
牙刷	dry_garbage
牙签	dry_garbage
牙膏	dry_garbage
牙齿	dry_garbage
牛	wet_garbage
牛仔裤	recyclable
牛尾	wet_garbage
牛杂	wet_garbage
牛筋	wet_garbage
牛肉粒包装袋	dry_garbage
牛蛙	wet_garbage
牛蛙骨头	wet_garbage
牛角	dry_garbage
牛鞭	wet_garbage
牡蛎壳	dry_garbage
牡蛎肉	wet_garbage
狗尿垫	dry_garbage
狗毛	dry_garbage
狗粮	wet_garbage
猕猴桃	wet_garbage
猪	wet_garbage
猪爪骨头	wet_garbage
猪肉铺	wet_garbage
猪脑	wet_garbage
猪脚	wet_garbage
猪腿骨	dry_garbage
猪蹄	wet_garbage
猫沙	dry_garbage
猫砂	dry_garbage
猫粮	wet_garbage
猫罐头	recyclable
猫饲料	wet_garbage
玉	dry_garbage
玉米	wet_garbage
玉米心	wet_garbage
玉米穗	wet_garbage
玉米衣	dry_garbage
玉镯	recyclable
玩偶	recyclable
玩具	recyclable
玫瑰	wet_garbage
玫瑰花	wet_garbage
环保布质垃圾袋	recyclable
环保袋	recyclable
环氧树脂	dry_garbage
玻璃	recyclable
玻璃制品	recyclable
玻璃制容器	recyclable
玻璃器皿	recyclable
玻璃壶	recyclable
玻璃密封容器	recyclable
玻璃尺	recyclable
玻璃摆件	recyclable
玻璃放大镜	recyclable
玻璃杯	recyclable
玻璃水瓶	recyclable
玻璃渣	recyclable
玻璃瓶	recyclable
玻璃电子秤	recyclable
玻璃盒	recyclable
玻璃胶	dry_garbage
玻璃花瓶	recyclable
玻璃蜡烛杯	recyclable
珊瑚	dry_garbage
珍珠	recyclable
珍珠米	wet_garbage
琉璃	recyclable
琼脂	wet_garbage
瓜	wet_garbage
瓜子仁	wet_garbage
瓜果	wet_garbage
瓜皮果核	wet_garbage
瓦斯桶	recyclable
瓦楞纸	recyclable
瓷制品	dry_garbage
瓷器	dry_garbage
瓷片	dry_garbage
瓷碎片	dry_garbage
瓷碗	dry_garbage
瓷酒瓶	dry_garbage
甘蔗	wet_garbage
甘蔗渣	wet_garbage
甘蔗皮	dry_garbage
甜卢蜀	wet_garbage
甜瓜	wet_garbage
甜甜圈	wet_garbage
甜芦粟	wet_garbage
甜芦粟皮	dry_garbage
甜芦黍	wet_garbage
生姜	wet_garbage
生日蜡烛	dry_garbage
生煎	wet_garbage
生煎包	wet_garbage
生菜	wet_garbage
生蚝	wet_garbage
用的创可贴	dry_garbage
用过的避孕套	dry_garbage
田螺	wet_garbage
甲油	harmful_waste
甲鱼	wet_garbage
甲鱼壳	dry_garbage
电冰箱	recyclable
电动保温箱	recyclable
电动刮痧板	recyclable
电动剃须刀	recyclable
电动卷发棒	recyclable
电动牙刷	recyclable
电动牙刷刷头	dry_garbage
电吹风	recyclable
电器	recyclable
电器产品	recyclable
电子书阅读器	recyclable
电子产品	recyclable
电子手表	recyclable
电子洗牙器	recyclable
电子温度计	recyclable
电子灭蚊拍	recyclable
电子烟烟弹	dry_garbage
电子琴	recyclable
电子血压仪	recyclable
电子表	recyclable
电子镇流器	recyclable
电容	recyclable
电容器	recyclable
电影票	recyclable
电扇	recyclable
电暖炉	recyclable
电源器	recyclable
电源线	recyclable
电灯	recyclable
电炖锅	recyclable
电烤箱	recyclable
电热毯	recyclable
电热水壶	recyclable
电热水袋	recyclable
电熨斗	recyclable
电瓶	recyclable
电磁炉	recyclable
电线	recyclable
电缆	recyclable
电脑	recyclable
电脑包	recyclable
电脑小音响	recyclable
电脑屏幕	recyclable
电脑机箱	recyclable
电脑设备	recyclable
电脑配件	recyclable
电蒸锅	recyclable
电蚊拍	recyclable
电蚊香液瓶	dry_garbage
电蚊香片	dry_garbage
电表盒	recyclable
电视	recyclable
电视机	recyclable
电视机顶盒	recyclable
电话	recyclable
电话卡	dry_garbage
电话机	recyclable
电话簿	recyclable
电费账单	recyclable
电路主板	recyclable
电路板	recyclable
电钻	recyclable
电锅	recyclable
电锯	recyclable
电阻	recyclable
电风扇	recyclable
电饭煲	recyclable
画框	recyclable
画笔	dry_garbage
画纸	recyclable
番茄	wet_garbage
番茄酱	wet_garbage
番茄酱包装袋	dry_garbage
番茄酱瓶	recyclable
番薯	wet_garbage
病人换下来的纸尿裤	dry_garbage
痘痘贴	dry_garbage
痰盂罐	recyclable
瘪掉的篮球	recyclable
登山杖	recyclable
登机牌	dry_garbage
白板擦	dry_garbage
白板笔	dry_garbage
白炽灯	harmful_waste
白炽灯泡	harmful_waste
白煮蛋壳	wet_garbage
白纸	recyclable
白菜	wet_garbage
白酒瓶	recyclable
百叶窗	recyclable
百洁布	dry_garbage
的确良	recyclable
皮具	recyclable
皮屑	dry_garbage
皮带	recyclable
皮球	recyclable
皮筋	dry_garbage
皮革	recyclable
皮革制品	recyclable
皮靴	recyclable
皮鞋	recyclable
盆	recyclable
盆栽	wet_garbage
盆栽树叶	wet_garbage
盆栽植物	wet_garbage
盐	wet_garbage
盐酸伐昔洛韦片	harmful_waste
盘尼西林	harmful_waste
盛装湿垃圾的垃圾袋	dry_garbage
直尺	dry_garbage
相册	recyclable
相机	recyclable
相框	recyclable
相片底片	harmful_waste
眉笔	dry_garbage
眉粉	dry_garbage
真空袋	dry_garbage
眼影	dry_garbage
眼镜	dry_garbage
眼霜	dry_garbage
睫毛刷	dry_garbage
睫毛膏	dry_garbage
短裤	dry_garbage
石灰干燥剂	dry_garbage
石膏	dry_garbage
矿水瓶	recyclable
矿泉水桶	recyclable
矿泉水瓶	recyclable
矿泉水瓶子	recyclable
矿泉水瓶盖	recyclable
矿物油	harmful_waste
矿物油包装物	harmful_waste
砂皮	dry_garbage
砂锅	dry_garbage
砧板	recyclable
破了的碗	recyclable
破布	recyclable
破损垃圾袋	dry_garbage
破损瓷器	dry_garbage
破瓷品	dry_garbage
破的碗	dry_garbage
破碗	dry_garbage
硅胶	dry_garbage
硅胶手环	dry_garbage
硅胶猫砂	dry_garbage
硅胶铲	dry_garbage
硅藻泥	dry_garbage
硬式磁碟机	recyclable
硬板纸	recyclable
硬果壳	dry_garbage
硬果实	dry_garbage
硬盘	recyclable
硬贝壳	dry_garbage
碎小肥皂	dry_garbage
碎布	recyclable
碎玻璃	recyclable
碎瓷	dry_garbage
碎瓷砖	dry_garbage
碎陶	dry_garbage
碎骨	wet_garbage
碗	dry_garbage
碗碟	dry_garbage
碘酒棉球	dry_garbage
碟片	dry_garbage
碧根果壳	dry_garbage
碱性无汞电池	dry_garbage
碱性电池	dry_garbage
碳灰	dry_garbage
碳粉匣	recyclable
碳纤维	dry_garbage
磁力片	dry_garbage
磁力贴	recyclable
磁卡	dry_garbage
磁带	dry_garbage
磁带播放器	recyclable
磁铁	recyclable
磨刀器	recyclable
磨砂膏	dry_garbage
票	dry_garbage
离心纸	dry_garbage
秋衣	recyclable
积木	recyclable
移动电源	recyclable
移动硬盘	recyclable
稀饭	wet_garbage
稻草	dry_garbage
空气净化器过滤网	recyclable
空气清新剂	dry_garbage
空罐头	recyclable
空调	recyclable
空调两用风扇	recyclable
空调扇	recyclable
空调机	recyclable
空调滤芯	dry_garbage
空调遥控器	recyclable
空酒瓶	recyclable
窗帘	recyclable
窗玻璃	recyclable
窗纱	dry_garbage
章鱼	wet_garbage
竹制品	dry_garbage
竹坐垫	dry_garbage
竹竿	dry_garbage
竹笋	wet_garbage
竹笛	dry_garbage
竹筷	dry_garbage
竹篮	dry_garbage
笋壳	wet_garbage
笋皮	wet_garbage
笔	dry_garbage
笔囊	dry_garbage
笔壳	dry_garbage
笔套	dry_garbage
笔屑	dry_garbage
笔杆	dry_garbage
笔盒	recyclable
笔盖	dry_garbage
笔筒	recyclable
笔芯	dry_garbage
笔袋	dry_garbage
笔记本	recyclable
笔记本电源	recyclable
笔记本电脑	recyclable
笔记本纸	recyclable
筒骨	dry_garbage
筷子	dry_garbage
签字笔	dry_garbage
篮球	recyclable
米	wet_garbage
米虫	wet_garbage
米饭	wet_garbage
粉尘	dry_garbage
粉底	dry_garbage
粉底液	dry_garbage
粉扑	dry_garbage
粉末类食品	wet_garbage
粉碎后的打印纸	dry_garbage
粉笔	dry_garbage
粉饼	dry_garbage
粉饼盒	dry_garbage
粘纸	dry_garbage
粘鼠板	dry_garbage
粟子壳	wet_garbage
粥	wet_garbage
粮食	wet_garbage
粽子	包扎线	dry_garbage
精华液瓶	recyclable
精华玻璃瓶	recyclable
糕点	wet_garbage
糕饼	wet_garbage
糖	wet_garbage
糖和藕粉	wet_garbage
糖果	wet_garbage
糖葫芦棍	dry_garbage
糠	wet_garbage
糠饼	wet_garbage
素菜	wet_garbage
紫砂碎片	dry_garbage
紫砂茶具	dry_garbage
紫菜	wet_garbage
红枣	wet_garbage
红烧肉	wet_garbage
红笔	dry_garbage
红糖	wet_garbage
红肠	wet_garbage
红茶包	dry_garbage
红薯	wet_garbage
红酒塞	dry_garbage
红酒瓶	recyclable
红领巾	recyclable
纯牛奶纸盒	recyclable
纱布	dry_garbage
纱窗	dry_garbage
纸	recyclable
纸制糖果礼盒	recyclable
纸团	dry_garbage
纸塑铝复合包装	recyclable
纸尿裤	dry_garbage
纸张	recyclable
纸张类	recyclable
纸张鞭炮	dry_garbage
纸杯	dry_garbage
纸板箱	recyclable
纸质商标	dry_garbage
纸质说明书	recyclable
纸质购物袋	recyclable
纺织品	recyclable
纺织布	recyclable
纺织物	recyclable
纽扣	dry_garbage
纽扣电池	harmful_waste
线	dry_garbage
线团	dry_garbage
线路板	recyclable
练习册	recyclable
练习本	recyclable
织物	recyclable
绒娃娃	recyclable
绒线衣	recyclable
结婚证书	recyclable
结成团的猫砂	dry_garbage
绘本	recyclable
绣花针	dry_garbage
绳子	dry_garbage
维生素	harmful_waste
绵拖鞋	recyclable
绷带	dry_garbage
绸带	recyclable
绿化	wet_garbage
绿叶菜	wet_garbage
绿植	wet_garbage
绿箩	wet_garbage
绿萝	wet_garbage
绿豆	wet_garbage
绿豆包装	dry_garbage
绿豆芽	wet_garbage
缎带	recyclable
编织袋	dry_garbage
缝纫针	dry_garbage
罐头	recyclable
罐头瓶	recyclable
网线	recyclable
羊毛	recyclable
羊毛衫	recyclable
羊肉	wet_garbage
羊蝎子	dry_garbage
羊蝎子骨头	dry_garbage
羊骨	dry_garbage
美妆蛋	dry_garbage
美容仪	recyclable
美工刀	recyclable
美术袋	dry_garbage
美术黏土	dry_garbage
美瞳	dry_garbage
美瞳包装	dry_garbage
美肤仪	recyclable
羽毛	dry_garbage
羽毛球	dry_garbage
羽绒被	recyclable
翡翠手镯	recyclable
老干妈辣酱	wet_garbage
老花眼镜	dry_garbage
老鼠药	harmful_waste
考卷	recyclable
考试卷	recyclable
耳塞	dry_garbage
耳套	recyclable
耳屎	dry_garbage
耳机	recyclable
耳环	recyclable
联通卡	dry_garbage
聚乙烯饭盒	dry_garbage
肉	wet_garbage
肉干	wet_garbage
肉沫	wet_garbage
肉蛋加工食品	wet_garbage
肉蛋及其加工食品	wet_garbage
肋排	wet_garbage
肋骨	dry_garbage
肥料	dry_garbage
肥皂	dry_garbage
肮脏塑料袋	dry_garbage
背包	recyclable
胡子	dry_garbage
胡椒粉	wet_garbage
胡渣	dry_garbage
胡萝卜	wet_garbage
胡须	dry_garbage
胡须刀	recyclable
胶卷	harmful_waste
胶囊	harmful_waste
胶囊咖啡	dry_garbage
胶布	dry_garbage
胶带	dry_garbage
胶棒	dry_garbage
胶水	dry_garbage
胶泥	dry_garbage
胶片	harmful_waste
胶画	dry_garbage
胶纸	dry_garbage
胸罩	dry_garbage
脆骨	wet_garbage
脏布	dry_garbage
脚垫	recyclable
脚指甲	dry_garbage
脚皮	dry_garbage
脚盆	recyclable
脚踏板	dry_garbage
脱氧剂	dry_garbage
脱水机	recyclable
脸摩仪	recyclable
脸盆	recyclable
腊肉	wet_garbage
腐肉	wet_garbage
腰带	recyclable
腰果	wet_garbage
腿骨	dry_garbage
膨化食品	wet_garbage
膨化食品包装	dry_garbage
自动铅	dry_garbage
自慰器	recyclable
自慰棒	recyclable
自暖包	dry_garbage
自来水滤芯	dry_garbage
臭袜子	dry_garbage
臭豆腐	wet_garbage
臭鸡蛋	wet_garbage
艾叶	wet_garbage
艾灸条	dry_garbage
艾灸渣	dry_garbage
艾灸贴	dry_garbage
艾草	wet_garbage
艾草灰	dry_garbage
艾草贴	dry_garbage
节能灯	harmful_waste
节能灯插座	recyclable
节能灯管	harmful_waste
芋圆	wet_garbage
芋头	wet_garbage
芋艿	wet_garbage
芒果	wet_garbage
芒果干	wet_garbage
芒果核	wet_garbage
芝士	wet_garbage
芝士片	wet_garbage
芝麻	wet_garbage
芥末包装	dry_garbage
芦稷	wet_garbage
芦稷皮	dry_garbage
芦苇叶	dry_garbage
芦荟	wet_garbage
芭比娃娃	recyclable
芭蕉叶	wet_garbage
花	wet_garbage
花卉	wet_garbage
花卉植物	wet_garbage
花卉绿植	wet_garbage
花朵	wet_garbage
花椒	wet_garbage
花泥	dry_garbage
花洒	recyclable
花洒软管	recyclable
花瓣	wet_garbage
花生	wet_garbage
花甲	dry_garbage
花盆	dry_garbage
花篮	dry_garbage
花肥	dry_garbage
花蛤	dry_garbage
花蛤壳	dry_garbage
花螺	wet_garbage
花露水塑料瓶	recyclable
花露水玻璃瓶	recyclable
花露水瓶	recyclable
芹菜	wet_garbage
芹菜叶	wet_garbage
苍蝇	wet_garbage
苍蝇拍	dry_garbage
英语书	recyclable
苹果	wet_garbage
苹果核	wet_garbage
苹果皮	wet_garbage
茄子	wet_garbage
茴香	wet_garbage
茶	wet_garbage
茶几	recyclable
茶包	dry_garbage
茶包装盒	recyclable
茶叶渣	wet_garbage
茶叶罐	recyclable
茶壶	dry_garbage
茶杯	dry_garbage
茶渣	wet_garbage
茶碗	dry_garbage
茶袋	dry_garbage
草	wet_garbage
草席	dry_garbage
草皮	wet_garbage
草稿本	recyclable
草稿纸	recyclable
草纸	dry_garbage
草药	wet_garbage
草莓	wet_garbage
荔枝壳	wet_garbage
荔枝干壳	wet_garbage
荔枝核	wet_garbage
荧光棒	dry_garbage
荧光灯管	harmful_waste
荧光笔	dry_garbage
荧幕	recyclable
药丸	harmful_waste
药剂	harmful_waste
药品	harmful_waste
药品内包装	harmful_waste
药材	wet_garbage
药片	harmful_waste
药物胶囊	harmful_waste
荷兰猪毛	dry_garbage
荷包蛋	wet_garbage
莲蓬	wet_garbage
莲藕	wet_garbage
莲雾	wet_garbage
菌菇	wet_garbage
菜	wet_garbage
菜刀	recyclable
菜叶	wet_garbage
菜叶包	dry_garbage
菜板	dry_garbage
菜根	wet_garbage
菜梗	wet_garbage
菜梗菜叶	wet_garbage
菜椒	wet_garbage
菜渣	wet_garbage
菜皮	wet_garbage
菜花	wet_garbage
菜饭	wet_garbage
菠菜	wet_garbage
菠萝	wet_garbage
菠萝干	wet_garbage
菠萝派	wet_garbage
菠萝蜜	wet_garbage
菠萝蜜核	dry_garbage
菱角	wet_garbage
萝卜	wet_garbage
萝卜干	wet_garbage
萤石	dry_garbage
营养琼脂	wet_garbage
落发	dry_garbage
落叶	wet_garbage
落花生	wet_garbage
葡萄	wet_garbage
葡萄枝	wet_garbage
葡萄柄	wet_garbage
葡萄皮	wet_garbage
葡萄籽	wet_garbage
葱	wet_garbage
葱蒜	wet_garbage
葵花子壳	wet_garbage
葵花籽	wet_garbage
葵花籽壳	wet_garbage
蒜	wet_garbage
蒸汽眼罩	dry_garbage
蓄电池	harmful_waste
蓝牙耳机	recyclable
蓝莓干	wet_garbage
蔓藤	wet_garbage
蔗糖	wet_garbage
蔬果	wet_garbage
蔬菜	wet_garbage
蔬菜茎叶	wet_garbage
薄型塑料袋	dry_garbage
薯片	wet_garbage
藤席	dry_garbage
藤蔓	wet_garbage
蘑菇	wet_garbage
蘸酱	wet_garbage
蘸酱盒	dry_garbage
虎牙	dry_garbage
虫	wet_garbage
虫子	wet_garbage
虾	wet_garbage
虾仁壳	wet_garbage
虾壳	wet_garbage
蚊子	wet_garbage
蚊帐	recyclable
蚊香	dry_garbage
蚌壳	dry_garbage
蚕丝	recyclable
蚕豆壳	wet_garbage
蚝油瓶	recyclable
蛇皮袋	dry_garbage
蛋	wet_garbage
蛋卷	wet_garbage
蛋壳	wet_garbage
蛋挞	wet_garbage
蛋挞壳	dry_garbage
蛋挞托	dry_garbage
蛋挞皮	wet_garbage
蛋挞盒	recyclable
蛋类	wet_garbage
蛋糕	wet_garbage
蛋糕盒	dry_garbage
蛋糕袋	dry_garbage
蛋黄	wet_garbage
蛋黄酥包装盒	dry_garbage
蛏子壳	dry_garbage
蛤蜊	wet_garbage
蛤蜊壳	dry_garbage
蛤蟆	wet_garbage
蜂蜜罐	recyclable
蜗牛壳	dry_garbage
蜘蛛	wet_garbage
蜜蜡	recyclable
蜜饯	wet_garbage
蜜饯塑料罐	recyclable
蜡油	dry_garbage
蜡烛	dry_garbage
蜡烛包装	dry_garbage
蜡烛塑料膜	dry_garbage
蜡笔	dry_garbage
蜡纸	dry_garbage
螃蟹	wet_garbage
螺丝	recyclable
螺丝刀	recyclable
螺丝钉	recyclable
螺帽	recyclable
螺狮	wet_garbage
螺狮壳	wet_garbage
螺纹帽	recyclable
螺纹盖	recyclable
螺钉	recyclable
蟑螂丸	harmful_waste
蟹	wet_garbage
蟹汁	wet_garbage
血压计	recyclable
行车记录仪	recyclable
衣夹	dry_garbage
衣服	recyclable
衣服半成品	recyclable
衣服吊牌	dry_garbage
衬衣	recyclable
衬衫	recyclable
袋泡茶	dry_garbage
被单	recyclable
被套	recyclable
被子	recyclable
被污染的垃圾袋	dry_garbage
被油渍污染的报纸	dry_garbage
被芯	recyclable
裁剪刀	recyclable
裤子	recyclable
裤袜	recyclable
西兰花	wet_garbage
西柚	wet_garbage
西洋参	wet_garbage
西瓜	wet_garbage
西瓜皮	wet_garbage
西瓜籽	wet_garbage
西红柿	wet_garbage
西药	harmful_waste
西装	recyclable
计算器	recyclable
计算机	recyclable
订书机	recyclable
订书机钉	dry_garbage
订书针	dry_garbage
订书钉	dry_garbage
记号笔	dry_garbage
证书	recyclable
试卷	recyclable
试纸	dry_garbage
话梅	wet_garbage
话筒	recyclable
语文书	recyclable
说明书	recyclable
课本	recyclable
调味料	wet_garbage
调味袋	dry_garbage
调料	wet_garbage
调料瓶	recyclable
谷物	wet_garbage
谷物及其加工食品	wet_garbage
豆浆机	recyclable
豆浆杯	dry_garbage
豆浆杯盖	dry_garbage
豆浆纸杯	recyclable
豆浆袋	dry_garbage
豆浆袋子	dry_garbage
豆渣	wet_garbage
豆类	wet_garbage
豆腐	wet_garbage
豆腐乳	wet_garbage
豆腐盒	dry_garbage
豌豆壳	wet_garbage
豌豆殼	wet_garbage
象棋	dry_garbage
象牙	dry_garbage
貂毛	dry_garbage
贝壳	dry_garbage
贝壳的肉	wet_garbage
贝壳类	dry_garbage
账单	recyclable
购物卡	dry_garbage
购物小票	dry_garbage
购物纸袋	recyclable
贴纸	dry_garbage
贺卡	recyclable
走油肉	wet_garbage
超市塑料袋	dry_garbage
超能胶	dry_garbage
足球	recyclable
路由器	recyclable
跳蛋	dry_garbage
跳跳糖包装袋	dry_garbage
蹄膀	wet_garbage
蹄膀骨头	dry_garbage
蹄髈	wet_garbage
车厘子	wet_garbage
车票	dry_garbage
车钥匙	dry_garbage
软木塞	dry_garbage
软盘	dry_garbage
软糖	wet_garbage
软骨	wet_garbage
辣条	wet_garbage
辣条包装袋	dry_garbage
辣椒	wet_garbage
辣酱	wet_garbage
辣酱瓶子	recyclable
过朝食品	wet_garbage
过期保健品	harmful_waste
过期化妆品	dry_garbage
过期口红	dry_garbage
过期护肤品	dry_garbage
过期的指甲油	harmful_waste
过期的燕麦片	wet_garbage
过期药	harmful_waste
过期药物	harmful_waste
过期防晒霜	dry_garbage
过期隐形眼镜	dry_garbage
过期食品	wet_garbage
过期饼干	wet_garbage
过滤器	dry_garbage
过滤盒	dry_garbage
过滤袋	dry_garbage
运动服	recyclable
运动鞋	recyclable
连衣裙	recyclable
连裤袜	recyclable
退热贴	dry_garbage
透明胶	dry_garbage
透明胶带	dry_garbage
逗猫棒	dry_garbage
速冻水饺	wet_garbage
速冻饺子	wet_garbage
速溶咖啡包装	dry_garbage
速溶饮料粉末	wet_garbage
遥控器	recyclable
遥控车	recyclable
遮阳帽	recyclable
避孕套	dry_garbage
避孕套包装	dry_garbage
避孕套包装盒	dry_garbage
避孕药	harmful_waste
酒瓶	recyclable
酒瓶塞子	dry_garbage
酒精棉片	dry_garbage
酒精棉球	dry_garbage
酒精棉花	dry_garbage
酒精瓶	recyclable
酒酿	wet_garbage
酱料	wet_garbage
酱汁	wet_garbage
酱油包装袋	dry_garbage
酱油玻璃瓶	recyclable
酱油瓶	recyclable
酱油袋	dry_garbage
酱菜瓶	recyclable
酸奶瓶	recyclable
酸奶盖	dry_garbage
酸奶袋	dry_garbage
醋包	dry_garbage
醋瓶	recyclable
醋袋	dry_garbage
金华火腿	wet_garbage
金器	recyclable
金属	recyclable
金属元件	recyclable
金属制品	recyclable
金属厨具	recyclable
金属地漏	recyclable
金属夹	recyclable
金属工具	recyclable
金属拉链	recyclable
金属拖把杆	recyclable
金属文件柜	recyclable
金属晾衣杆	recyclable
金属汤匙	recyclable
金属瓶盖	recyclable
金属瓶罐	recyclable
金属盒	recyclable
金属管	recyclable
金属罐	recyclable
金属钥匙扣	recyclable
金属门吸	recyclable
金属零件	recyclable
金属饰品盒	recyclable
金属香炉	recyclable
金属鱼竿	recyclable
金属鱼钩	recyclable
金戒指	recyclable
金手链	recyclable
金枪鱼罐头	recyclable
金项链	recyclable
金鱼	wet_garbage
鋁箔	recyclable
针	dry_garbage
针灸针	dry_garbage
针筒	dry_garbage
针管	dry_garbage
钉子	recyclable
钓鱼竿	dry_garbage
钓鱼线	dry_garbage
钓鱼钩	dry_garbage
钟	dry_garbage
钟表	recyclable
钢丝	recyclable
钢丝球	dry_garbage
钢化玻璃	recyclable
钢化膜	dry_garbage
钢尺	recyclable
钢琴	recyclable
钢笔	dry_garbage
钢笔里的墨囊	dry_garbage
钥匙	recyclable
钨丝	recyclable
钨丝灯泡	harmful_waste
钮扣	dry_garbage
钻石	recyclable
钻笔	dry_garbage
铁	recyclable
铁圈	recyclable
铁块	recyclable
铁尺	recyclable
铁杯	recyclable
铁架	recyclable
铁棍	recyclable
铁皮	recyclable
铁钉	recyclable
铁钩	recyclable
铁锤	recyclable
铂金纸	dry_garbage
铃铛	recyclable
铅桶	recyclable
铅笔	dry_garbage
铅芯	dry_garbage
铅酸电池	harmful_waste
铜牌	recyclable
铜皮	recyclable
铝	recyclable
铝制品	recyclable
铝合金	recyclable
铝喷雾瓶	recyclable
铝盆	recyclable
铝盖	recyclable
铝箔	recyclable
铝箔纸	recyclable
铝箔袋	recyclable
铝管	recyclable
铝罐	recyclable
铝膜	recyclable
银行卡	recyclable
锁	recyclable
锁头	recyclable
锅	recyclable
锅巴	wet_garbage
锅盖	dry_garbage
锡箔	dry_garbage
锤子	recyclable
键盘	recyclable
镇流器	recyclable
镉镍电池	harmful_waste
镍镉电池	harmful_waste
镜子	dry_garbage
长寿果壳	dry_garbage
长尾夹	recyclable
长毛绒	recyclable
长生果	wet_garbage
长靴	recyclable
门锁	recyclable
闹钟	recyclable
防撞塑料	dry_garbage
防晒喷雾	dry_garbage
防晒衣	recyclable
防晒霜	dry_garbage
防晒霜罐	recyclable
防油纸	dry_garbage
防滑垫	recyclable
防潮剂	dry_garbage
防潮盒	recyclable
防潮袋	dry_garbage
防碎气泡膜	dry_garbage
防腐剂	dry_garbage
防蚊手环	dry_garbage
防蚊贴	dry_garbage
防震膜	dry_garbage
防霉防蛀片	dry_garbage
阿司匹林	harmful_waste
阿尔卑斯糖	wet_garbage
陈皮	wet_garbage
除氧剂	dry_garbage
除湿剂	dry_garbage
除湿包	dry_garbage
除湿机	recyclable
除湿盒	recyclable
除湿袋	dry_garbage
除草剂	harmful_waste
陶器	dry_garbage
陶瓷	dry_garbage
陶瓷制品	dry_garbage
陶罐	dry_garbage
隐形眼镜	dry_garbage
隐形眼镜片	dry_garbage
隔夜菜	wet_garbage
隔夜饭	wet_garbage
隔热杯套	recyclable
隔离霜	dry_garbage
雅漾喷雾	dry_garbage
集成电路板	recyclable
雨伞	dry_garbage
雨刮器	dry_garbage
雨披	dry_garbage
雨靴	recyclable
雨鞋	recyclable
雪碧瓶	recyclable
雪糕棒	dry_garbage
雪糕纸	dry_garbage
零食	wet_garbage
零食包装袋	dry_garbage
零食罐	dry_garbage
零食袋	dry_garbage
電池	harmful_waste
震动棒	recyclable
青椰	dry_garbage
青菜	wet_garbage
青蟹	wet_garbage
非大型化妆镜	dry_garbage
靠垫	recyclable
靠枕	recyclable
面	wet_garbage
面包	wet_garbage
面包袋	dry_garbage
面巾纸	dry_garbage
面巾纸包装纸	dry_garbage
面条	wet_garbage
面条包装袋	dry_garbage
面粉	wet_garbage
面粉袋	dry_garbage
面膜	dry_garbage
面膜包装袋	dry_garbage
面膜外层纸	dry_garbage
面霜	dry_garbage
面霜瓶	recyclable
鞋	recyclable
鞭炮	dry_garbage
韭菜	wet_garbage
音响	recyclable
音箱	recyclable
项链	recyclable
领带	recyclable
颜料	dry_garbage
颜料板	dry_garbage
颜料笔	dry_garbage
风干食品	wet_garbage
风扇	recyclable
风油精	dry_garbage
风油精瓶	dry_garbage
风筝	dry_garbage
风衣	recyclable
飞刀	recyclable
飞机杯	dry_garbage
食品	wet_garbage
食品与日用品塑料瓶罐及瓶盖	recyclable
食品保鲜盒	recyclable
食品及日用品玻璃瓶罐	recyclable
食品干燥剂	dry_garbage
食品桶	recyclable
食品用脱氧剂	dry_garbage
食品罐	recyclable
食材废料	wet_garbage
食物托盘	recyclable
食物残渣及宠物饲料	wet_garbage
食用油桶	recyclable
餐厅纸	dry_garbage
餐巾	dry_garbage
餐巾纸	dry_garbage
餐盒	dry_garbage
餐纸	dry_garbage
餐饮外卖盒	dry_garbage
饭	wet_garbage
饭团	wet_garbage
饭团包装	dry_garbage
饭汁	wet_garbage
饭盒	dry_garbage
饭菜	wet_garbage
饮料瓶	recyclable
饰品	dry_garbage
饲料	wet_garbage
饲料袋	dry_garbage
饺子	wet_garbage
饼干	wet_garbage
饼干包装袋	dry_garbage
饼干盒	recyclable
饼干袋	dry_garbage
馒头	wet_garbage
香烟	dry_garbage
香烟灰烬	dry_garbage
香烟蒂	dry_garbage
香烟过滤嘴	dry_garbage
香皂	dry_garbage
香肠	wet_garbage
香菇	wet_garbage
香蕉	wet_garbage
马克杯	dry_garbage
马克笔	dry_garbage
马夹袋	dry_garbage
马桶刷	dry_garbage
马桶盖	recyclable
马肉	wet_garbage
马铃薯	wet_garbage
马铃薯片	wet_garbage
驱蚊瓶	recyclable
验孕棒	dry_garbage
骨头	dry_garbage
骨肉相连	wet_garbage
高压锅	recyclable
高密度碎纸机处理的碎纸	dry_garbage
高尔夫球杆	recyclable
高粱	wet_garbage
高裤腰带	dry_garbage
高跟鞋	recyclable
高铁酸钾	harmful_waste
高附加值可回收物	recyclable
魔力擦	dry_garbage
魔方	dry_garbage
魔笔	dry_garbage
魔芋粉包装	dry_garbage
鱼	wet_garbage
鱼内脏	wet_garbage
鱼刺	wet_garbage
鱼汤	wet_garbage
鱼缸	recyclable
鱼网	dry_garbage
鱼肠	wet_garbage
鱼骨	wet_garbage
鱼鳞	wet_garbage
鱼鳞鱼肠	wet_garbage
鱿鱼	wet_garbage
鲍鱼	wet_garbage
鲍鱼壳	dry_garbage
鲜花	wet_garbage
鸟笼	dry_garbage
鸡	wet_garbage
鸡屁股	wet_garbage
鸡排	wet_garbage
鸡旦壳	wet_garbage
鸡毛掸	dry_garbage
鸡毛掸子	dry_garbage
鸡爪	wet_garbage
鸡精	wet_garbage
鸡翅	wet_garbage
鸡翅膀	wet_garbage
鸡翅骨头	wet_garbage
鸡肝	wet_garbage
鸡胸	wet_garbage
鸡腿	wet_garbage
鸡蛋	wet_garbage
鸡蛋包装盒	recyclable
鸡蛋塑料保护壳	recyclable
鸡蛋盒	recyclable
鸭	wet_garbage
鸭屁股	wet_garbage
鸭脖	wet_garbage
鸭脖子	wet_garbage
鸭血	wet_garbage
鸭骨	wet_garbage
鸽子	wet_garbage
鹅	wet_garbage
麦丽素	wet_garbage
麦克风	recyclable
麦子	wet_garbage
麦当劳纸袋	dry_garbage
麦秆	wet_garbage
麻将台	recyclable
麻将牌	dry_garbage
麻布	recyclable
麻油瓶	recyclable
麻绳	dry_garbage
麻袋	dry_garbage
麻辣烫	wet_garbage
黄桃	wet_garbage
黄桃罐头	recyclable
黄油	wet_garbage
黄油包装纸	dry_garbage
黄瓜	wet_garbage
黄豆	wet_garbage
黄金	recyclable
黄金饰品	recyclable
黄鱼	wet_garbage
黑板	recyclable
黑板擦	dry_garbage
黑框眼镜	dry_garbage
黑猪	wet_garbage
黑珍猪	wet_garbage
黑笔	dry_garbage
黑胶唱片	dry_garbage
黑豆	wet_garbage
默写本	recyclable
鼠标	recyclable
鼻屎	dry_garbage
鼻毛	dry_garbage
鼻涕纸	dry_garbage
鼻贴	dry_garbage
齿轮	recyclable
龙虾	wet_garbage
龙虾壳	wet_garbage